Ocean	minecraft:ocean	0
Deep Ocean	minecraft:deep_ocean	24
Frozen Ocean	minecraft:frozen_ocean	10
Deep Frozen Ocean	minecraft:deep_frozen_ocean	50
Cold Ocean	minecraft:cold_ocean	46
Deep Cold Ocean	minecraft:deep_cold_ocean	49
Lukewarm Ocean	minecraft:lukewarm_ocean	45
Deep Lukewarm Ocean	minecraft:deep_lukewarm_ocean	48
Warm Ocean	minecraft:warm_ocean	44
Deep Warm Ocean	minecraft:deep_warm_ocean	47
River	minecraft:river	7
Frozen River	minecraft:frozen_river	11
Beach	minecraft:beach	16
Stone Shore	minecraft:stone_shore	25
Snowy Beach	minecraft:snowy_beach	26
Forest	minecraft:forest	4
Wooded Hills	minecraft:wooded_hills	18
Flower Forest	minecraft:flower_forest	132
Birch Forest	minecraft:birch_forest	27
Birch Forest Hills	minecraft:birch_forest_hills	28
Tall Birch Forest	minecraft:tall_birch_forest	155
Tall Birch Hills	minecraft:tall_birch_hills	156
Dark Forest	minecraft:dark_forest	29
Dark Forest Hills	minecraft:dark_forest_hills	157
Jungle	minecraft:jungle	21
Jungle Hills	minecraft:jungle_hills	22
Modified Jungle	minecraft:modified_jungle	149
Jungle Edge	minecraft:jungle_edge	23
Modified Jungle Edge	minecraft:modified_jungle_edge	151
Bamboo Jungle	minecraft:bamboo_jungle	168
Bamboo Jungle Hills	minecraft:bamboo_jungle_hills	169
Taiga	minecraft:taiga	5
Taiga Hills	minecraft:taiga_hills	19
Taiga Mountains	minecraft:taiga_mountains	133
Snowy Taiga	minecraft:snowy_taiga	30
Snowy Taiga Hills	minecraft:snowy_taiga_hills	31
Snowy Taiga Mountains	minecraft:snowy_taiga_mountains	158
Giant Tree Taiga	minecraft:giant_tree_taiga	32
Giant Tree Taiga Hills	minecraft:giant_tree_taiga_hills	33
Giant Spruce Taiga	minecraft:giant_spruce_taiga	160
Giant Spruce Taiga Hills	minecraft:giant_spruce_taiga_hills	161
Mushroom Fields	minecraft:mushroom_fields	14
Mushroom Field Shore	minecraft:mushroom_field_shore	15
Swamp	minecraft:swamp	6
Swamp Hills	minecraft:swamp_hills	134
Savanna	minecraft:savanna	35
Savanna Plateau	minecraft:savanna_plateau	36
Shattered Savanna	minecraft:shattered_savanna	163
Shattered Savanna Plateau	minecraft:shattered_savanna_plateau	164
Plains	minecraft:plains	1
Sunflower Plains	minecraft:sunflower_plains	129
Desert	minecraft:desert	2
Desert Hills	minecraft:desert_hills	17
Desert Lakes	minecraft:desert_lakes	130
Snowy Tundra	minecraft:snowy_tundra	12
Snowy Mountains	minecraft:snowy_mountains	13
Ice Spikes	minecraft:ice_spikes	140
Mountains	minecraft:mountains	3
Wooded Mountains	minecraft:wooded_mountains	34
Gravelly Mountains	minecraft:gravelly_mountains	131
Gravelly Mountains+	minecraft:modified_gravelly_mountains	162
Mountain Edge	minecraft:mountain_edge	20
Badlands	minecraft:badlands	37
Badlands Plateau	minecraft:badlands_plateau	39
Modified Badlands Plateau	minecraft:modified_badlands_plateau	167
Wooded Badlands Plateau	minecraft:wooded_badlands_plateau	38
Modified Wooded Badlands Plateau	minecraft:modified_wooded_badlands_plateau	166
Eroded Badlands	minecraft:eroded_badlands	165
Nether	minecraft:nether	8
The End	minecraft:the_end	9
Small End Islands	minecraft:small_end_islands	40
End Midlands	minecraft:end_midlands	41
End Highlands	minecraft:end_highlands	42
End Barrens	minecraft:end_barrens	43
The Void	minecraft:the_void	127